$ANSIBLE_VAULT;1.1;AES256
32343137386362336663663935346166653437326335613131393530303437383133316164366561
6338653336376332396563626630643864643636616364640a366539376532336133613736343233
62633864396535343338653963653930633761373432616537353739626530323039326433326666
6264303430343666330a316635646262663866366335613639346662386331303433396333363637
34303137323862626236656165303466353461633363616666363434613438363133313364616537
37323837623033616633613831623365633636303035376131393334333266353734636530353765
30313332613936653262623161623836623630623065373330373566626636363033383038363234
36653939386236346234353034376235623635303063343664333766346334636566333237613736
30636234663939653432656136343362373332393436373064323762323930626333623438643063
33663063326436373264323339373834333431323833376430636165313063656133396431393538
36393164623234613931316232306166346332383032356439383764363661313035616661633434
36653330616339313663656161343762316464623166363930653539656639346438613162303837
31626338393432346638346661616639613361346131353837373336656433313566383734653436
34646263646133663764616361363034626662663839616632323136653130313661663139626639
30626639633763353135343036346666333539393631303265323831356239383732663263346364
63623833643139376235346333646437633635323431373332353664643538386366353061343861
65613365393366653664633234316232313365373132363635326565346435653036393439323332
32323561346165613331316565313163623332376330346366313433383836663366333531316132
35633034643437613231326365663339323334633265313633376431363263376337353832376662
35356337636437613731633762656638636337323135663932346561343265616131353331383335
38383536333134653734353333633634326331323735663533396263373063333434646635373065
33343634356438613064383861366366383634363138393939363466373536616362376536363535
36663961333564646230323863346531313062363135663234656230393861613632623430383362
66633961656664393231396334613765333566313637336562636166363237373036353163326662
66393733383062386533353964633932663537393830383262333462633262623134663263323231
37326530373265396364353533643233313334313339373338303739336461613934376134376465
32316632383363653861336161323065346131616632396138336363656437363334393838303436
64623737363030626133623730663563643163666162383162626662663937303030353636643131
34663734336139393766663634623663643766313761656463613735326238386130
