$ANSIBLE_VAULT;1.1;AES256
35346334353264613737333531313861653439363662626134313063613962303461333362613935
3965353633303732656366356366663662343962323965630a643336353132373261323137303530
30343632353337623835633839663034333763643564393065666636343732333166393138663433
3635396463366663340a386333323638393334633037333563343437313539653432313161323464
66633664303361653932336366613862383665653930383366343262363030363166633331336538
32623464313136323234633833366666366664623564636430643035336633653166363735653264
39343139663238643234613338373432623832313538383633636136653132646536376635666462
35303762373465363361313934313163643861633537383839306337316138646661353964633261
61396139656233616536323035323932643233653230353463376366623464333234643934303266
62353061653561396566323036313637333134323662393538366435376339326232306434383630
62376530333031323061633332656462346261303138303232393532616334663635386430626131
38666266393232663232613363313861333638613963386635313362303832316230393830323666
61356461376530396464396433376139313736386666303735653338323032316431623432313961
34633361356632633931306366336533316663306362663635333565316334643433333765396634
63636235373665373533396134633036303639663832343665336532663536646563326238326531
66363536663965336637363165623137643832356361646639363532363338653432386565613634
65336232363332663332633235626234623262333236323762376439326338326632616165623837
35326335376234653665333564306338663531323063396461616266623430356165666132626162
31313038623535653966383932363438363831393864363465666137396434666561343038666630
65343436393638396238643933373962373337303930393537633031306634643632326639323932
37306436663834303431393466633566333264636135663035663462616335363165663035623464
34633533613766336137313230383039656631316235663136383937353962366532326164393033
373034633164353162343437396533663235
